################
#   #          #
#   #          #
#              #   
###  #         # 
#     #        #   
# #            #       
#   #          #
#     #        #
#  #   #       #
#          E   #
################
