################
#   #          #
#   #  #   #   #
#         #    #   
###  #   #     # 
#     #     #  #   
# #    E  #    #       
#   #     #    #
#     #     #  #
#  #   #       #
#              #
################
