################
#   #          #
#   #  #   #   #
#         #    #   
###  #   #     # 
#     #     #  #   
# #       #    #       
#   #     #    #
#     #     #  #
#  #   #       #
#          E   #
################
